# VOX LEXICON
#
# Parsed by create.py.
# Format:
#word: (noun|adjective|verb) "f aa" 'n iy m' 's'
# NOTE: Doublequotes indicates primary stress, single indicates no stress.
#
# Phonemes are taken from here (must be lowercase): http://www.speech.cs.cmu.edu/cgi-bin/cmudict
# pau = short pause
#
aft: adjective 'ae f t'
animes: noun 'ae' 'n ih' 'm ey s'
array: noun 'ah r ey'
asimov: adjective "ae" 'z ih' 'm aa v'
ass: noun 'ae s'
asshole: noun "ae s" 'hh ow l'
biohazard: adjective "b ay" 'ow' 'hh ae' 'z er d'
bitch: noun "b ih t" 'ch'
brig: noun 'b r ih g'
centcomm: noun "s eh n t" 'k aa m'
code: noun "k ow d d"
comdom: adjective "k aa m" 'd aa m'
connor: noun "k ao n" 'n er'
coward: noun "k aw" 'w er d'
cunt: noun 'k ah n' 't'
cyborg: noun "s ay" 'b ao r g'
delamination: verb "d iy" 'l ae' 'm ih' 'n ey' 'sh ih n'
five: noun 'f ay' 'v pau'
fore: adjective 'f ao r'
fuck: noun 'f ah' 'k'
help: noun "hh eh l" 'p'
ion: noun "ay" 'aa n'
laws: noun "l aa" 'aa z'
lawyer: noun "l oy" 'y er'
meteors: noun "m iy" 't iy' 'er s'
medbay: noun "m eh d" 'b ey'
medical: noin "m eh" 'd ih' 'k ah l'
nanotrasen: noun "n ae" 'n ow' 't r ey' 'z eh n'
nine: noun 'n' 'ay n'
no: noun 'n' 'ow'
penis: noun "p iy" 'n ih s'
penises: noun "p iy" 'n ih s' 'eh s'
rads: noun 'r ae' 'd t s'
rogue: adjective 'r ow g' 'ah'
sarah: noun "s eh" 'r ah'
shit: noun 'sh ih t'
shitting: verb "sh ih" 't iy ng'
solar: noun "s ow" 'l er'
tajaran: noun 't aa' "hh aa" 'r eh n'
telecomms: noun "t eh" 'l ah' 'k aa m s'
the: noun 'dh iy'
thirteen: noun 'th er' "t iy n"
tide: noun "t ay" 'd pau'
to: noun "t uw" 'uw'
virology: noun "v ay" 'r aw l' 'l eh' 'g iy'
vox: noun 'v aa k s'
wanker: noun "w ae n" 'k er'
xeno: noun "z eh" 'n ow'
xenobiology: noun "z iy" 'n ow' 'b ay' 'aw' 'l eh' 'g iy'
xenomorph: noun "z iy" 'n ow' 'm ao r f'
xenomorphs: noun "z iy" 'n ow' 'm ao r f' 's'